XXXXXXXXXXXXXXXXXXXXXX
X XXX XX   XXXXXXXX  X 
X          XXXXXXXX  X
X X XXXX   XXXXXXXX  X
X XX XX    XXXXXXXX  X
X  X @XX   XXXXXXXX  X
XXXXXXXX             X
X         X XXXXXXXXXX
X  XXXXX  X X        X
X  XXXXX  X X   *    X
X  XXXXX  X X        X
X         X          X
XXXXXXXXXXXXXXXXXXXXXX