XXXXXXXXXXXXXX
X@XXX XXXXXXXX
X            X
X XX XXXXX XXX
XXXX XX*   XXX
X     XXXXXXXX
XXXXXXXXXXXXXX